111111111111111111111111111111111111111111111111111111111111111111111111111111113311
11111111111111111111111111111111111111111111111111111111111111111111111111111111  11
11111111111111111111111111111111111111111111111111111111111111111111111111111111  11
11                                    11                        111111111111  11  11
11                                    11                        111111111111  11  11
11  22222222222222222222222222222222  11  111111  111111111111                11  11
11  22222222222222222222222222222222  11  111111  111111111111                11  11
11  11  11  11                11  11  11  11  11  1111      11111111111111111111  11
11  11  11  11                11  11  11  11  11  1111      11111111111111111111  11
11  11                            11  11  11  11                                  11
11  11                            11  11  11  11                                  11
11  11                            11          11  2222      222222222222222222    11
11  11        2222                11          11  2222      222222222222222222    11
11  11        2222                11  11  111111  222222222222              11111111
11  11                            11  11  111111  222222222222              11111111
11  11                            11  11  11                        111111        11
11  11                            11  11  11                        111111        11
11  11    1111              1111  11  11  11                        11      1111  11
11  11                      1111  11  11  11                        11      1111  11
11  11                  111111    11  11  1111111111111111111111111111  11111111  11
11  11                  111111    11  11  1111111111111111111111111111  11111111  11
11  11  11  11          11        11  11                                11        11
11  11  11  11          11        11  11                                11        11
11  1111111111      111111        11  11  2222222222222222222222222222  11        11
11  1111111111      111111        11  11  2222222222222222222222222222  11        11
11  11    111111111111            11  11      22          11    11      11        11
11  11    111111111111            11  11      22          11    11      11        11
11  11    11                    1111  11  11  22  11      11    11  11  11        11
11  11    11                    1111  11  11  22  11      11    11  11  11        11
11  11  1111  1111  2222222222222222  11  11      11      11        11  111111111111
11  11  1111  1111  2222222222222222  11  11      11      11        11  111111111111
11  11        11                      11  1111111111      11    11  11            11
11  11        11                      11  1111111111      11    11  11            11
11  222222222222  1111111111111111111111  11      11      11111111  11  11111111  11
11  222222222222  1111111111111111111111  11      11      11111111  11  11111111  11
11                                        11      11                11  111111111111
11                                        11      11                11  111111111111
1111111111111111  111111111111111111  111111      1111111111111111  11            11
1111111111111111  111111111111111111  111111      1111111111111111  11            11
1111          11  11            11      1111                11  11  11          1111
1111          11  11            11      1111                11  11  11          1111
1111          11  11            11                                      11111111  11
1111          11  11            11                                      11111111  11
1111          11        2222    11      11111111  11111111  11  111111    111111  11
1111          11        2222    11      11111111  11111111  11  111111    111111  11
1111          11  11    2222    1111111111                  11  11111111          11
1111          11  11    2222    1111111111                  11  11111111          11
1111  2222222222  11            11      11    11  22222222  11  11111111111111111111
1111  2222222222  11            11      11    11  22222222  11  11111111111111111111
1111              11                        1111  22222222  11                111111
1111              11                        1111  22222222  11                111111
1111111111  11  222222222222  1111111111111111      222222  11                111111
1111111111  11  222222222222  1111111111111111      222222  11                111111
11          11  22        22      11        11  11  222222  11                    11
11          11  22        22      11        11  11  222222  11                    11
11  111111  11  2222222222222222        11  11      22      11                11  11
11  111111  11  2222222222222222        11  11      22      11                11  11
11      11  11                    11    11      11      11  11                11  11
11      11  11                    11    11      11      11  11                11  11
11      2222222222222222  111111111111111111111111111111111111                11  11
11      2222222222222222  111111111111111111111111111111111111                11  11
11                                                        1111                11  11
11                                                        1111                11  11
11111111111111111111111111111111111111111111111111111111  11111111111111111111111111
11111111111111111111111111111111111111111111111111111111  11111111111111111111111111
111111111111111111111111111111111111111111111111111111111111111111111111111111111111